R  600 400
NO ./img/003_genbu_300-300.xpm
SO ./img/004_suzaku_300-300.xpm
WE ./img/005_byakko_300-300.xpm
EA ./img/002_seiryu_300-300.xpm

S ./img/001_kirin_300-300.xpm

F 72,72,72
C 128,128,128

11111
110011111111111111111111
100000100010000100000001
102200100010000100000001
100000000010000100000001
100000100000200000001001
1N0000100000000001000001
111111111111111111111111
