R  600 400
NO ./img/003_genbu_300-300.xpm
SO ./img/004_suzaku_300-300.xpm
WE ./img/005_byakko_300-300.xpm
EA ./img/002_seiryu_300-300.xpm

S ./img/001_kirin_150-150.xpm

F 33,33,33
C 144,144,144

111111111
100000001
100002001           111111111
1000000011111111    100000201
1111102000200001    1000200011111111
     11100000001   1000000000000201
     111000200W1    1102001111000001
     11111111111    1110001   110101
                      10011    10101
                      10111    11111
                      11111
