R  960    720
NO ./img/110_gakuseiryou_278-300.xpm
SO ./img/112_nekoboy_250-250.xpm
WE ./img/109_hikikomori_250-250.xpm
EA ./img/113_chunigirl_300-300.xpm

S ./img/107_badboys_300-300.xpm
C 66,150,200
F 99,99,99

        1111111111111111111111111
        1000000000110000000000001
        1011000001110000002000001
        1001000000000000000000001
111111111011002001110000000000001
100000000011000001110111111111111
11110111111111011100000010001
11110111111111011101010010001
11000000110101011100020002001
10002000000000000020000010001
10000000000200001101010010001
11000001110101011111011110N0111
11110111 1110101 101111010001
11111111 1111111 111111111111