R  800 600
NO ./img/105_ninomiya_240-240_s.xpm
SO ./img/103_yobikoh_83-100.xpm
WE ./img/106_keiziban_200-200_s.xpm
EA ./img/104_kyoshitsu_160-138.xpm

S ./img/102_sotsugyou.png_200-150_s.xpm
F 72,72,72
C 128,128,128

111111111111111111111111111
1000000000000S0000000000001
100000000000000000002000001
100000000000000000000000001
100000000000000200000000001
100000002000000000000000001
111110000000000000111111111
101100000000000000000000001
100000020000000000000000001
100000000000000020000000001
100000000000000000000000001
100000000000000000000000001
100000000000000000000000001
100000000000000000000000001
100000000000000000000000001
100000000000000000000000001
100000000000000000000000001
111111111111111111111111111
111111111111111111111111111