R  600 400
NO ./img/109_hikikomori_250-250.xpm
SO ./img/109_hikikomori_250-250.xpm
WE ./img/109_hikikomori_250-250.xpm
EA ./img/109_hikikomori_250-250.xpm

S ./img/113_chunigirl_300-300.xpm
C 66,66,66
F 88,88,88

        111111111111111
     111000000000000000111
    11020020000000002002001
   1000000111111111110000001
  100020111         110002001
 100000111           110000001
102000111            1110000001
10000111              110020001
10020111              110000001
12000111              110000001
10000111              110000001
100000111             110020001
 100200111           110000001
 1000000111        1100020001
  10000000111111111002000001
   100002000000000000000001
    11100000002N0000020011
      111111111111111111