R  1920 1280
NO ./img/210_kagaminumi_132-150.xpm
SO ./img/204_kannushi_200-200.xpm
WE ./img/209_chozuya_200-249.xpm
EA ./img/211_furuhudanousho_250-250.xpm

S ./img/206_kadomatsu_200-200_s.xpm
C 128,128,128
F 255,188,188

1111111111111111111111111111111111111111111111111111111111111111
1200000020000000000000020000000000020000020000000000000200002001
1000000000E00000000200000000002000000000000000020000000002000001
1000000000000000000002020000000000002000020000000000000200200001
1000000000000000000000000000200000002000000020200000000000000001
1111111111111111111111111111111111111111111111111111111111111111