R  720 400
NO ./img/301_hyobaku_124-124.xpm
SO ./img/308_dablam_146-100.xpm
WE ./img/307_everest_150-98.xpm
EA ./img/306_omiwatari_150-134.xpm

S ./img/309_hokkyokuusagi_140-146.xpm
C 128,188,255
F 255,255,255

1111111111111
1000002000201
1200000200001
1E00002020201
1002000002001
1200002000001
1111111111111