R  800 300
NO ./img/300_yukimatsuri_200-200.xpm
SO ./img/303_yukidaruma-family_100-63.xpm
WE ./img/305_takibi_267-200.xpm
EA ./img/304_ohutongirl_125-125_s.xpm

S ./img/302_tokedaruma_196-196_s.xpm
F 72,72,72
C 128,128,128

111111111111111111111111
100000100010000100000001
100000102010000100020001
100000000010020100000001
100000102000000000001001
1N0000100000000000000001
111111111111111111111111