R  200 200
NO ./img/206_kadomatsu_100-100.xpm
SO ./img/207_otoshidama_100-157_s.xpm
WE ./img/203_kagamimochi_400-400.xpm
EA ./img/208_matsukazari_100-120_s.xpm

S ./img/201_omamori_300-300_s.xpm
F 72,72,72
C 128,128,128

1111111111111111111111111111111111111111111111111111111111111111111111111111111111111111111111111111
1E00000001100000000110000000011000000001100000000110000000011000000001100000000110000000011000000001
1000000000000000000110000000011000000001100000000110000000011000000001100000000110000000011000000001
1000000000020000000110000000011000000001100000000110000000011000000001100000000110000000011000000001
1000000000000000000110000000011000000001100000000110000000000000000001100000000110000000011000000001
1000000001100020000110000000011000000001100000000110000000011000000001100000000110000000011000000001
1000000001100000000110000000011000000001100000000110000000011000000001100000000110000000011000000001
1000000001100000000110000000011000000001100000000110000000000000000001100000000110000000011000000001
1000000001100000000110000000011000000001100000000110000000011000000001100000000110000000011000000001
1000000001100000000110000000011000000001100000000110000000011000000001100000000110000000011000000001
1111111111111000111111111111111111000111111110001111111001111111011011111111111111111111111111111111
1000000001100000000110000000011000000001100000000110000000011000000001100000000110000000011000000001
1000000001100000000110000000011000000001100000000110000000011000000001100000000110000000011000000001
1000000001100000000110000000011000020000000000000110000000011000000001100000000110000000011000000001
1000000001100020000000000000011000000001100000000110000000011000000001100000000110000000011000000001
1000000001100000000110000000011000000001100000000110000000011000000001100000000110000000011000000001
1000000001100000000110000000011000000001100000000110000000011000000001100000000110000000011000000001
1000000001100000000110000000011000000001100000000000000000011000000001100000000110000000011000000001
1000000001100000000000000000011000000001100000000110000000011000000001100000000110000000011000000001
1000000001100000000110000000011000000001100000000110000000011000000001100000000110000000011000000001
1111111111111100011111111111111111111111111111111111111111111111100001111111111111111111111111111111
1000000001100000000110000000011000000001100000000110000000011000000001100000000110000000011000000001
1000000001100000000110000000011000000001100000000110000000011000000001100000000110000000011000000001
1000000001100000000000000000011000000001100000000110000000011000000001100000000110000000011000000001
1000000001100000000110000000011000000001100000000110000000011000000001100000000110000000011000000001
1000000001100002000110000000011000000001100000000110000000011000000001100000000110000000011000000001
1000000001100000000110000000011000000001100000000110000000011000000001100000000110000000011000000001
1000000001100000000110000000011000000001100000000110000000011000000001100000000110000000011000000001
1000000001100000000110000000011000000001100000000110000000011000000001100000000110000000011000000001
1000000001100000000110000000011000000001100000000110000000011000000001100000000110000000011000000001
1111111111111111111111111111111111111111111111111111111111111111111111111111111111111111111111111111
1000000001100000000110000000011000000001100000000110000000011000000001100000000110000000011000000001
1000000001100000000110000000011000000001100000000110000000011000000001100000000110000000011000000001
1000000001100000000110000000011000000001100000000110000000011000000001100000000110000000011000000001
1000000001100000000110000000011000000001100000000110000000011000000001100000000110000000011000000001
1000000001100000000110000000011000000001100000000110000000011000000001100000000110000000011000000001
1000000001100000000110000000011000000001100000000110000000011000000001100000000110000000011000000001
1000000001100000000110000000011000000001100000000110000000011000000001100000000110000000011000000001
1000000001100000000110000000011000000001100000000110000000011000000001100000000110000000011000000001
1000000001100000000110000000011000000001100000000110000000011000000001100000000110000000011000000001
1111111111111111111111111111111111111111111111111111111111111111111111111111111111111111111111111111
1000000001100000000110000000011000000001100000000110000000011000000001100000000110000000011000000001
1000000001100000000110000000011000000001100000000110000000011000000001100000000110000000011000000001
1000000001100000000110000000011000000001100000000110000000011000000001100000000110000000011000000001
1000000001100000000110000000011000000001100000000110000000011000000001100000000110000000011000000001
1000000001100000000110000000011000000001100000000110000000011000000001100000000110000000011000000001
1000000001100000000110000000011000000001100000000110000000011000000001100000000110000000011000000001
1000000001100000000110000000011000000001100000000110000000011000000001100000000110000000011000000001
1000000001100000000110000000011000000001100000000110000000011000000001100000000110000000011000000001
1000000001100000000110000000011000000001100000000110000000011000000001100000000110000000011000000001
1111111111111111111111111111111111111111111111111111111111111111111111111111111111111111111111111111
1000000001100000000110000000011000000001100000000110000000011000000001100000000110000000011000000001
1000000001100000000110000000011000000001100000000110000000011000000001100000000110000000011000000001
1000000001100000000110000000011000000001100000000110000000011000000001100000000110000000011000000001
1000000001100000000110000000011000000001100000000110000000011000000001100000000110000000011000000001
1000000001100000000110000000011000000001100000000110000000011000000001100000000110000000011000000001
1000000001100000000110000000011000000001100000000110000000011000000001100000000110000000011000000001
1000000001100000000110000000011000000001100000000110000000011000000001100000000110000000011000000001
1000000001100000000110000000011000000001100000000110000000011000000001100000000110000000011000000001
1000000001100000000110000000011000000001100000000110000000011000000001100000000110000000011000000001
1111111111111111111111111111111111111111111111111111111111111111111111111111111111111111111111111111
1000000001100000000110000000011000000001100000000110000000011000000001100000000110000000011000000001
1000000001100000000110000000011000000001100000000110000000011000000001100000000110000000011000000001
1000000001100000000110000000011000000001100000000110000000011000000001100000000110000000011000000001
1000000001100000000110000000011000000001100000000110000000011000000001100000000110000000011000000001
1000000001100000000110000000011000000001100000000110000000011000000001100000000110000000011000000001
1000000001100000000110000000011000000001100000000110000000011000000001100000000110000000011000000001
1000000001100000000110000000011000000001100000000110000000011000000001100000000110000000011000000001
1000000001100000000110000000011000000001100000000110000000011000000001100000000110000000011000000001
1000000001100000000110000000011000000001100000000110000000011000000001100000000110000000011000000001
1111111111111111111111111111111111111111111111111111111111111111111111111111111111111111111111111111
1000000001100000000110000000011000000001100000000110000000011000000001100000000110000000011000000001
1000000001100000000110000000011000000001100000000110000000011000000001100000000110000000011000000001
1000000001100000000110000000011000000001100000000110000000011000000001100000000110000000011000000001
1000000001100000000110000000011000000001100000000110000000011000000001100000000110000000011000000001
1000000001100000000110000000011000000001100000000110000000011000000001100000000110000000011000000001
1000000001100000000110000000011000000001100000000110000000011000000001100000000110000000011000000001
1000000001100000000110000000011000000001100000000110000000011000000001100000000110000000011000000001
1000000001100000000110000000011000000001100000000110000000011000000001100000000110000000011000000001
1000000001100000000110000000011000000001100000000110000000011000000001100000000110000000011000000001
1111111111111111111111111111111111111111111111111111111111111111111111111111111111111111111111111111
1000000001100000000110000000011000000001100000000110000000011000000001100000000110000000011000000001
1000000001100000000110000000011000000001100000000110000000011000000001100000000110000000011000000001
1000000001100000000110000000011000000001100000000110000000011000000001100000000110000000011000000001
1000000001100000000110000000011000000001100000000110000000011000000001100000000110000000011000000001
1000000001100000000110000000011000000001100000000110000000011000000001100000000110000000011000000001
1000000001100000000110000000011000000001100000000110000000011000000001100000000110000000011000000001
1000000001100000000110000000011000000001100000000110000000011000000001100000000110000000011000000001
1000000001100000000110000000011000000001100000000110000000011000000001100000000110000000011000000001
1000000001100000000110000000011000000001100000000110000000011000000001100000000110000000011000000001
1111111111111111111111111111111111111111111111111111111111111111111111111111111111111111111111111111
1000000001100000000110000000011000000001100000000110000000011000000001100000000110000000011000000001
1000000001100000000110000000011000000001100000000110000000011000000001100000000110000000011000000001
1000000001100000000110000000011000000001100000000110000000011000000001100000000110000000011000000001
1000000001100000000110000000011000000001100000000110000000011000000001100000000110000000011000000001
1000000001100000000110000000011000000001100000000110000000011000000001100000000110000000011000000001
1000000001100000000110000000011000000001100000000110000000011000000001100000000110000000011000000001
1000000001100000000110000000011000000001100000000110000000011000000001100000000110000000011000000001
1000000001100000000110000000011000000001100000000110000000011000000001100000000110000000011000000001
1111111111111111111111111111111111111111111111111111111111111111111111111111111111111111111111111111