R  730 400
NO ./img/110_gakuseiryou_278-300.xpm
SO ./img/110_gakuseiryou_278-300.xpm
WE ./img/110_gakuseiryou_278-300.xpm
EA ./img/110_gakuseiryou_278-300.xpm

S ./img/105_ninomiya_180-180.xpm
F 72,72,72
C 128,128,128

1111111
1000001
1000001
1200001
1000021
1000001
1000001
1002001
1000001
1000001
1200001
1000001
1000201
1000001
1000001
1000001
1020001
1000001
1000021
1020001
1000001
1000001
1000001
1000001
1000001
100N001
1000001
1111111