R  600 400
NO ./img/tex_noth.xpm
SO ./img/tex_south.xpm
WE ./img/tex_west.xpm
EA ./img/tex_east.xpm

S ./img/tex_sprite.xpm
F 72,72,72
C 128,128,128

1111111111111111111111111111111111111111111111111111111111111111
1200000020000000000000020000000000020000020000000000000200002001
1000000000E00000000200000000002000000000000000020000000002000001
1000000000000000000002020000000000002000020000000000000200200001
1000000000000000000000000000200000002000000020200000000000000001
1111111111111111111111111111111111111111111111111111111111111111