R  600 400
NO ./img/tex_noth.xpm
SO ./img/tex_south.xpm
WE ./img/tex_west.xpm
EA ./img/tex_east.xpm

S ./img/tex_sprite.xpm
F 72,72,72
C 128,128,128

111111111111111111111111
100000100010000100000001
100000100010000100000001
100000000010000100000001
100000100000000000001001
1N0000100000000000000001
111111111111111111111111