R  960 720
NO ./img/tex_noth.xpm
SO ./img/tex_south.xpm
WE ./img/tex_west.xpm
EA ./img/tex_east.xpm

S ./img/tex_sprite.xpm
F 72,72,72
C 128,128,128

1111111111111111111111111111111111111111111111111111111111111111
1200000020000000000000000000000000000000020000000000000000000001
1000000000E00000000000000000002000000000000000020000000000000001
1000000000000000000000000000000000002000000000000000000000000001
1111111111111111111111111111111111111111111111111111111111111111